111111111111111111111111
111122222222222222111111
111223333333333332211111
112233333333333333221111
112333333333333333321111
112333333111333333321111
112333311111133333321111
112333333311133333332111
112333333332113333321111
112233333332333333221111
111223333332333332211111
111122222222222222111111
111111111111111111111111
111111111111111111111111
111111111111111111111111
