1111111111
1111111111
1222222211
1233333211
1233333211
1233333211
1222222211
1111111111
1111111111
1111111111
