000000111111211
000001111333211
000011133332211
001111222222110
111111211111100
111113211100000
111333211100111
111332211001111
222222111000000
111111100000000
000000000111111
000011111122223
111111111223333
111111112233333
111222222333333
